0000000S1000000
000F00001000100
000000001000100
111110001110100
000000001000111
000000001000000
000111111001111
000000000000000
000000000001111
000000001000000
001000001000000
001000001001111
001000001001000
001110001001000
001010001001000