######################
#        #      #    #
#      #    #        #
#  #                 #
#        #      #    #
#  #                 #
#        #      #    #
#        #           #
#        #      #    #
#      #    #        #
#  #                 #
#        #      #    #
#  #                 #
#        #      #    #
#        #      #    #
#      #    #        #
#  #                 #
#        #      #    #
#  #                 #
#        #      #    #
#        #           #
#        #      #    #
######################